15 14
###############
#             #
#             #
#             #
# ####       ##
# 1### ########
#   ###########
#   #####    ##
#   ####     ##
#######  ##  ##
#            ##
#            ##
#           2##
###############
