12 12
############
############
###   # ####
###    1  ##
### ### ####
### ### ####
### ### ####
### ########
###2########
############
############
############