15 10
###############
#             #
#             #
#    #####    #
#    2#  #    #
#     #  #    #
#     #  #    #
#     ##1#    #
#        #    #
###############