9 6
#########
#       #
#   #####
# 21#   #
#    #  #
#########