9 6
#########
#       #
#   #####
#  1#   #
#   2#  #
#########