##################
#1111#222#########
#1111#222#########
#1111F222222######
#1111#7##222#EEEE#
#111135##22G#EEEE#
#1111######D#EEEE#
#11114689ABCEEEEE#
##################

1,F
1,3
1,4
4,6
6,8
8,9
9,A
A,B
B,C
C,D
C,E
D,2
F,2
2,G
2,G


##########
#1#000000#
#1##000000
0000000000
0000000000